5x9
000100000
011100000
013000000
001113100
000000200