5x9
001110000
001001100
000010000
001000100
000000002