5x9
111000000
011100000
013000000
001113100
000000200