5x9
000100000
011100000
011000000
001111100
000000200