10x10
1100001000
0111311100
0000000100
1111000100
0001000100
0011113100
0010000000
0013111110
0000000010
0021111310