10x10
0100001000
0111111100
0000000100
1111000100
0001000100
0011111100
0010000000
0011111110
0000000010
0021111110