10x10
0000001100
0111001100
0100000100
0110000100
0000000100
0011111100
0010000000
0010111110
0010000010
0011111120