12x15
001001001000100
011111111110000
010000000010000
011111110011110
000000010000010
011111111111010
010000000001010
011101111101010
010001000001010
011101011111110
010000010000020
011111111111110