12x15
111001000000000
001131110000000
000000010000000
011113110000110
000100010000010
001111131111010
010000000001010
011101111113010
010001000001010
011311013111110
010000010000000
031211311111110