12x15
001001000000000
001111110000000
000000010000000
011111110000110
000100010000010
001111111111010
010000000001010
011101111111010
010001000001010
011111011111110
010000010000000
011211111111110